5 5 5 5 5 5 5 5 5 5 5 5 5 5 5 8
0 0 0 0 0 0 2 2 2 2 2 2 2 2 2 6
6 3 4 4 0 0 0 0 0 0 0 0 0 0 0 6
6 0 0 0 0 0 0 0 0 0 0 0 0 0 0 6
6 0 0 0 0 0 2 2 2 2 2 2 2 0 0 6
6 0 0 0 0 0 0 0 0 0 0 0 0 0 0 6
6 0 0 0 0 0 2 2 2 2 2 2 2 0 0 6
6 0 0 0 0 0 0 0 0 0 0 0 0 0 0 6
6 0 0 0 0 0 2 2 2 2 2 2 2 0 0 6
6 0 0 0 0 0 0 0 0 0 0 0 0 0 0 6
8 7 7 0 0 0 7 7 7 7 7 7 7 7 7 8
5 5 5 1 1 1 5 5 5 5 5 5 5 5 5 5 