4   3   3   3   3   3   3   3   3   3   3   3   3   3   3   4
1   0   0   0   0   0   0   0   0   0   0   0   0   0   0   3
1   20  21  21  21  0   0   0   0   0   0   0   0   0   0   0
1   0   0   0   0   0   0   0   0   30  30  30  30  0   0   0
1   0   0   30  30  30  30  0   0   0   0   0   0   0   0   1
1   0   0   0   0   0   0   0   0   30  30  30  30  0   0   1
1   0   0   30  30  30  30  0   0   0   0   0   0   0   0   1
3   0   0   0   0   0   0   0   0   30  30  30  30  0   0   1
0   0   0   0   30  30  30  0   0   0   0   0   0   0   0   1
0   0   0   0   0   0   0   0   0   30  30  30  30  0   0   1
1   0   0   0   0   0   0   0   0   0   0   0   0   0   0   1
4   2   2   2   2   2   2   2   2   2   2   2   2   2   2   4