4 3 3 3 3 3 3 3 3 3 3 3 3 3 3 4
1 0 0 0 0 0 0 0 0 0 0 0 0 0 0 1
1 0 0 0 0 0 0 0 0 0 0 0 0 0 0 1
1 0 0 0 0 0 0 0 0 0 0 0 0 0 0 1
3 0 0 0 0 0 0 0 0 0 0 0 3 3 0 1
0 0 0 0 0 0 0 0 0 0 0 0 3 3 0 1
0 0 0 0 0 0 0 0 0 0 0 0 3 3 0 1
1 0 0 0 2 2 2 2 2 0 0 0 0 0 0 1
1 0 0 0 2 2 2 2 2 0 0 0 0 0 0 1
1 0 0 0 2 2 2 2 2 0 0 0 0 0 0 1
1 0 0 0 0 0 0 0 0 0 0 0 0 0 0 1
4 2 2 2 2 2 2 2 2 2 2 2 2 2 2 4