5 5 5 5 5 5 5 5 5 5 5 5 5 5 5 9
2 2 2 2 2 2 22 22 22 22 22 22 22 22 22 6
15 23 3 3 0 0 2 2 2 2 2 2 2 2 2 6
6 2 2 2 0 0 0 0 0 0 0 0 0 0 0 6
6 0 0 0 0 0 22 22 22 22 22 22 22 0 0 6
6 0 0 0 0 0 2 2 2 2 2 2 2 0 0 6
6 0 0 0 0 0 22 22 22 22 22 22 22 0 0 6
6 0 0 0 0 0 2 2 2 2 2 2 2 0 0 6
6 0 0 0 0 0 22 22 22 22 22 22 22 0 0 6
6 0 0 0 0 0 2 2 2 2 2 2 2 0 0 6
4 7 16 0 0 0 17 7 7 7 7 7 7 7 7 8
5 5 12 2 2 2 13 5 5 5 5 5 5 5 5 5 
