1 1 1 1 1 1 1 1 11 5 5 5 5 5 5 5 
1 1 1 1 1 1 1 1 6 20 2 2 2 2 2 2 
1 1 1 1 1 1 1 1 6 0 0 0 0 0 0 14 
1 1 1 1 1 1 1 1 6 0 0 0 0 21 0 6 
1 1 1 1 1 1 1 1 6 0 0 0 0 0 0 6 
1 1 1 1 1 1 1 1 4 7 7 7 7 7 7 8 
1 1 1 1 1 1 1 1 5 5 5 5 5 5 5 5  
1 1 1 1 1 1 1 1 1 1 1 1 1 1 1 1 
1 1 1 1 1 1 1 1 1 1 1 1 1 1 1 1 
1 1 1 1 1 1 1 1 1 1 1 1 1 1 1 1 
1 1 1 1 1 1 1 1 1 1 1 1 1 1 1 1 
1 1 1 1 1 1 1 1 1 1 1 1 1 1 1 1 